11_11.jpg
11_12.jpg
11_13.jpg
11_14.jpg
11_15.jpg
11_16.jpg
11_17.jpg
11_18.jpg
11_20.jpg
11_26.jpg
11_27.jpg